NO textures/Brick_Wall.xpm
SO textures/Brick_Wall_Cracked.xpm
WE textures/Green_Wall_Rocks.xpm
EA textures/Wooden_Floor_Horizontal.xpm

F 255,0,0
C 255,0,0

11111111111111111111111111111111111111111111111111111111111111111111111111111111111111111111111111111111
10S00000000000000000000000000000000000000000000000000000000000000000000000000000000000000000000000000001
11111111111111111111111111111111111111111111111111111111111111111111111111111111111111111111111111111111