NO textures/Brick_Wall.xpm
SO textures/Brick_Wall_Cracked.xpm
WE textures/Green_Wall_Rocks.xpm
EA textures/Wooden_Floor_Horizontal.xpm

F 255,255,0
C 255,0,0

                                                    111111111111111111111
                                                    100000000000000000001
                                                    101111111111111111111
                                                    101
                                                    101
                                                    101
                                                    101
                                                    101
                                                    101
                                                    101
111                                                 101
101                                                 101
101                                                 101
101                                                 101
101                                                 101
10111111111111111111111111111111111111111111111111111011111111111111111111111111111111111111111111111111
10000000000000000000000000000000000000000000000000000W00000000000000000000000000000000000000000000000001
11111111111111111111111111111111111111111111111111110011111111111111111111111111111111111111111111111111
101                                                101
101                                                101
101                                                101
101                                                101
101                                                101
101                                                101
101                                                101
111                                                111
                                                  111







